、 - rao
。 - hai
一 - ges
七 - un
三 - das
上 - ki
下 - puo
不 - ti
中 - no
九 - ja
乳 - zao
乾 - i
亀 - ta
二 - ni
五 - uo
交 - ya
人 - yu
今 - tua
仙 - tain
代 - su
令 - xon
似 - xa
位 - pu
低 - pai
住 - za
何 - rang
信 - ri
做 - ka
元 - uom
兄 - won
充 - xuom
光 - gu
兎 - buom
兜 - pi
入 - wua
八 - zung
公 - kuang
六 - to
兵 - ju
其 - xe
内 - ain
冬 - si
冷 - ba
出 - xao
分 - rong
列 - ru
刺 - dul
剣 - yi
創 - e
加 - re
助 - zus
勺 - aon
包 - ul
北 - wung
区 - bo
医 - kus
十 - ku
千 - du
南 - yo
去 - xo
反 - tuan
口 - zol
古 - jao
可 - guo
含 - gaong
吹 - nuom
和 - reng
員 - yel
唔 - nang
唖 - uol
善 - hu
四 - zel
団 - muo
囲 - dua
国 - nao
園 - ruo
土 - jail
地 - has
型 - hi
埋 - dain
城 - yua
塩 - tos
境 - ai
壊 - ge
士 - di
売 - po
夏 - zos
夕 - kuom
外 - zuo
多 - kuas
夜 - guom
大 - u
天 - nai
夫 - gi
奶 - pa
好 - we
妹 - dong
妻 - yan
姉 - te
威 - suo
嫌 - ais
子 - mao
季 - ten
学 - xu
守 - jung
宗 - yos
家 - yin
寄 - be
寝 - jua
将 - xai
少 - mus
尓 - tu
尖 - juom
居 - bos
屋 - in
山 - jo
川 - ye
巷 - wis
市 - tis
布 - run
帳 - bi
常 - yas
幼 - tong
広 - hes
店 - a
廻 - kua
弓 - sa
引 - puang
弟 - ko
当 - ma
律 - se
心 - ken
怒 - jas
思 - gua
恨 - xas
悪 - ail
悲 - ban
意 - ren
成 - tul
我 - was
戦 - gil
手 - dal
技 - jing
押 - ril
拘 - zuom
拾 - zas
持 - na
指 - ho
掌 - ung
揚 - o
散 - muas
数 - zu
整 - zan
新 - kel
方 - hing
於 - gon
旗 - dail
日 - ga
明 - da
星 - gang
春 - xuang
昴 - jis
昼 - daol
時 - il
晴 - xul
暗 - rel
曙 - buo
曲 - zuan
更 - bu
書 - ji
月 - dol
服 - xuas
朝 - rus
木 - pal
未 - xi
杓 - duan
来 - haing
杭 - bes
東 - wa
枯 - zes
柑 - mai
柱 - ha
栗 - yil
根 - ding
棚 - yuom
概 - wu
機 - dai
欠 - je
正 - dao
此 - sai
歩 - ua
歪 - zua
歯 - neng
段 - mu
母 - gao
民 - hung
気 - yaol
水 - yai
氷 - yus
永 - nu
汲 - nung
治 - raong
泰 - ze
活 - ne
流 - sin
浮 - jos
海 - ro
済 - huan
温 - tuos
測 - guan
港 - jul
湾 - zul
溢 - nuos
滅 - gan
火 - wi
炒 - xain
点 - uos
為 - kas
焔 - ing
焼 - bel
燦 - me
爪 - pul
父 - gen
片 - ping
牛 - wol
狭 - yal
獣 - bua
玄 - yen
率 - jin
玉 - yain
珈 - bol
現 - sol
瑠 - bus
生 - pong
田 - tal
画 - huom
病 - wuang
痛 - buan
登 - bai
白 - des
百 - pao
的 - an
皇 - zo
皿 - duo
盤 - nen
目 - xol
盾 - ra
矢 - nuo
短 - yao
石 - duon
砂 - pe
破 - he
硫 - os
磁 - yon
秋 - ual
秒 - bong
穴 - man
竹 - mi
算 - suom
篭 - wai
米 - eng
粒 - song
粘 - zais
粥 - hon
糖 - ang
糸 - rua
累 - go
組 - wel
緑 - wan
縫 - ron
羅 - kan
羊 - sul
美 - zaon
老 - mon
肉 - do
肌 - saong
肝 - juan
育 - ging
胃 - xua
腎 - xual
腸 - us
臣 - wing
良 - so
色 - ao
花 - xos
茄 - zai
茶 - maing
草 - xen
菜 - sua
蔓 - zis
蕎 - kong
蕪 - bao
薔 - kuo
蘇 - xuo
蘊 - jai
虫 - xung
蛸 - puom
蜘 - hel
蝋 - xuon
衆 - den
行 - as
表 - wuom
袋 - men
裏 - hul
西 - wos
要 - yung
見 - rul
覚 - hao
角 - zun
記 - deng
話 - el
読 - mul
謝 - bin
貝 - tin
貫 - yais
買 - juo
費 - kul
赤 - geng
赦 - ben
超 - bas
越 - puol
足 - ke
踵 - hol
車 - paon
軍 - mua
軸 - raol
軽 - zi
辛 - duas
農 - sao
近 - nes
通 - gus
道 - kes
遠 - rai
遡 - ong
都 - gaing
酔 - yis
醜 - pua
重 - xong
金 - haon
鉄 - huas
銀 - hen
銃 - tan
銅 - tao
銭 - min
録 - paos
鎧 - jil
長 - saon
陰 - xan
隊 - sos
雛 - hua
雨 - sung
雪 - meng
雲 - zang
電 - wo
青 - sel
非 - uan
響 - mo
領 - aol
頭 - zil
願 - huos
風 - bung
飛 - zaing
食 - waon
飲 - hang
餅 - ol
馬 - pen
駅 - daong
骨 - pos
高 - yong
魂 - gual
魔 - kain
魚 - pes
鳥 - tuol
麦 - kun
麺 - gai
黄 - ris
黒 - gol
鼻 - mang
